115 Browser=1B
2345 Browser=2B
360 Phone Browser=36
360 Browser=3B
Avant Browser=AA
ABrowse=AB
ANT Fresco=AF
ANTGalio=AG
Aloha Browser=AL
Aloha Browser Lite=AH
Amaya=AM
Amigo=AO
Android Browser=AN
AOL Desktop=AE
AOL Shield=AD
Arora=AR
Arctic Fox=AX
Amiga Voyager=AV
Amiga Aweb=AW
Atom=A0
Atomic Web Browser=AT
Avast Secure Browser=AS
AVG Secure Browser=VG
Avira Scout=AC
AwoX=A1
Beaker Browser=BA
Beamrise=BM
BlackBerry Browser=BB
Baidu Browser=BD
Baidu Spark=BS
Basilisk=BI
Beonex=BE
BlackHawk=BH
Bunjalloo=BJ
B-Line=BL
Blue Browser=BU
Borealis Navigator=BN
Brave=BR
BriskBard=BK
BrowseX=BX
Browzar=BZ
Biyubi=BY
Byffox=BF
Camino=CA
CCleaner=CL
Centaury=C0
Coc Coc=CC
CoolBrowser=C4
Colibri=C2
Comodo Dragon=CD
Coast=C1
Charon=CX
CM Browser=CE
Chrome Frame=CF
Headless Chrome=HC
Chrome=CH
Chrome Mobile iOS=CI
Conkeror=CK
Chrome Mobile=CM
CoolNovo=CN
CometBird=CO
COS Browser=CB
Cornowser=CW
Chim Lac=C3
ChromePlus=CP
Chromium=CR
Cyberfox=CY
Cheshire=CS
Crusta=CT
Craving Explorer=CG
Crazy Browser=CZ
Cunaguaro=CU
Chrome Webview=CV
dbrowser=DB
Deepnet Explorer=DE
Deledao=DA
Delta Browser=DT
DeskBrowse=DS
Dolphin=DF
Dorado=DO
Dot Browser=DR
Dooble=DL
Dillo=DI
DuckDuckGo Privacy Browser=DD
Ecosia=EC
Epic=EI
Elinks=EL
Element Browser=EB
Elements Browser=EE
eZ Browser=EZ
EUI Browser=EU
GNOME Web=EP
Espial TV Browser=ES
Falkon=FA
Faux Browser=FX
Firefox Mobile iOS=F1
Firebird=FB
Fluid=FD
Fennec=FE
Firefox=FF
Firefox Focus=FK
Firefox Reality=FY
Firefox Rocket=FR
Flock=FL
Flow=FO
Firefox Mobile=FM
Fireweb=FW
Fireweb Navigator=FN
Flast=FS
FreeU=FU
Galeon=GA
Ghostery Privacy Browser=GH
GinxDroid Browser=GI
Glass Browser=GB
Google Earth=GE
GOG Galaxy=GO
HasBrowser=HS
Hawk Turbo Browser=HA
hola! Browser=HO
HotJava=HJ
Huawei Browser=HU
IBrowse=IB
iCab=IC
iCab Mobile=I2
Iridium=I1
Iron Mobile=I3
IceCat=I4
IceDragon=ID
Isivioo=IV
Iceweasel=IW
Internet Explorer=IE
IE Mobile=IM
Iron=IR
Japan Browser=JB
Jasmine=JS
Jig Browser=JI
Jig Browser Plus=JP
Jio Browser=JO
K.Browser=KB
Kindle Browser=KI
K-meleon=KM
Konqueror=KO
Kapiko=KP
Kinza=KN
Kiwi=KW
Kode Browser=KD
Kylo=KY
Kazehakase=KZ
Cheetah Browser=LB
LieBaoFast=LF
LG Browser=LG
Light=LH
Links=LI
Lolifox=IF
Lovense Browser=LO
LuaKit=LU
Lulumi=LL
Lunascape=LS
Lunascape Lite=LN
Lynx=LX
mCent=M1
MicroB=MB
NCSA Mosaic=MC
Meizu Browser=MZ
Mercury=ME
Mobile Safari=MF
Midori=MI
Mobicip=MO
MIUI Browser=MU
Mobile Silk=MS
Minimo=MN
Mint Browser=MT
Maxthon=MX
MxNitro=NM
Mypal=MY
Monument Browser=MR
MAUI WAP Browser=MW
Navigateur Web=NW
NFS Browser=NR
Nokia Browser=NB
Nokia OSS Browser=NO
Nokia Ovi Browser=NV
Nox Browser=NX
NetSurf=NE
NetFront=NF
NetFront Life=NL
NetPositive=NP
Netscape=NS
NTENT Browser=NT
Oculus Browser=OC
Opera Mini iOS=O1
Obigo=OB
Odin=O2
Odyssey Web Browser=OD
Off By One=OF
OhHai Browser=HH
ONE Browser=OE
Opera GX=OX
Opera Neon=OG
Opera Devices=OH
Opera Mini=OI
Opera Mobile=OM
Opera=OP
Opera Next=ON
Opera Touch=OO
Orca=OA
Ordissimo=OS
Oregano=OR
Origin In-Game Overlay=O0
Origyn Web Browser=OY
Openwave Mobile Browser=OV
OmniWeb=OW
Otter Browser=OT
Palm Blazer=PL
Pale Moon=PM
Polypane=PY
Oppo Browser=PP
Palm Pre=PR
Puffin=PU
Palm WebPro=PW
Palmscape=PA
Perfect Browser=PE
Phantom Browser=PH
Phoenix=PX
Phoenix Browser=PB
PlayFree Browser=PF
Polaris=PO
Polarity=PT
PolyBrowser=LY
PrivacyWall=PI
Microsoft Edge=PS
QQ Browser Lite=Q2
QQ Browser Mini=Q1
QQ Browser=QQ
Qutebrowser=QT
Quark=QU
QupZilla=QZ
Qwant Mobile=QM
QtWebEngine=QW
Realme Browser=RE
Rekonq=RK
RockMelt=RM
Samsung Browser=SB
Sailfish Browser=SA
Seewo Browser=S8
SEMC-Browser=SC
Sogou Explorer=SE
Safari=SF
Safe Exam Browser=S5
SalamWeb=SW
SFive=SV
Shiira=SH
SimpleBrowser=S1
Sizzy=SY
Skyfire=SK
Seraphic Sraf=SS
Sleipnir=SL
Slimjet=S6
SP Browser=S7
7Star=7S
Smart Lenovo Browser=LE
Smooz=OZ
Snowshoe=SN
Sogou Mobile Browser=SO
Splash=S2
Sputnik Browser=SI
Sunrise=SR
SuperBird=SP
Super Fast Browser=SU
surf=S3
Stargon=SG
START Internet Browser=S0
Steam In-Game Overlay=S4
Streamy=ST
Swiftfox=SX
Seznam Browser=SZ
T-Browser=TR
t-online.de Browser=TO
Tao Browser=TA
TenFourFox=TF
Tenta Browser=TB
Tizen Browser=TZ
Tungsten=TU
ToGate=TG
TweakStyle=TS
TV Bro=TV
UBrowser=UB
UC Browser=UC
UC Browser HD=UH
UC Browser Mini=UM
UC Browser Turbo=UT
UR Browser=UR
Uzbl=UZ
Venus Browser=VE
Vivaldi=VI
vivo Browser=VV
Vision Mobile Browser=VB
VMware AirWatch=VM
Wear Internet Browser=WI
Web Explorer=WP
WebPositive=WE
Waterfox=WF
Whale Browser=WH
wOSBrowser=WO
WeTab Browser=WT
Yahoo! Japan Browser=YJ
Yandex Browser=YA
Yandex Browser Lite=YL
Yaani Browser=YN
Yolo Browser=YB
xStand=XS
Xiino=XI
Xvast=XV
Zetakey=ZE
Zvu=ZV